11111111111111111111
10P000C00000000000E1
11111111111111111111 