11111111111111111111111
1PC00000000000000000001
10000111100001000000001
10000100100001000000001
10000111000001000000001
10000100000001111000001
100000000000000000000E1
11111111111111111111111