111111111111111111111111111111
1P000C111111100000000000000001
100011000000001000111100000001
1000000000000C1000000000011101
1000000111111110000000000000C1
100000000000000000111100000001
1C00000000000000000000000000E1
111111111111111111111111111111